8
8
CHHHHHHH
SSSSSSSS
HHSHSHHH
SSSSSSSS
SHHHHHHS
SSSSSSSS
HSHHHHSH
SSSSSSSS
Policia1;0;5
Policia2;7;3