20
20
HHHAAHHHAHSSHHSHSSAH
SSSSSSSSSSSSSSSSSSSS
SHHSHHHSHHHHSHHSHHHH
SSSSSSSSSSSSSSSSSSSS
HHHASHHHCHSSHHSHSSHH
SSSSSSSSSSSSSSSSSSSS
HHSHSHHHSHHHSHHHHHHH
SSSSSSSSSSSSSSSSSSSS
SHHHHHHSHHHHHHHSHSSS
SSSSSSSSSSSSSSSSSHHH
HSHHHHSAHSHHHHSHSSSS
SSSSSSSSSSSSSSSSSHHH
SHHHHHHHHHHHSHHHSSSS
SSSSSSSSSSSSSSSSSSSS
HHSHSHHHHHSHSHHHHHHH
SSSSSSSSSSSSSSSSSSSS
SHHHHHHSAHHHHHHSHHSH
SSSSSSSSSSSSSSSSSSSS
HSHHHHSHHSHHHHSHSSSH
SSSSSSSSSSSSSSSSSSSS
Policia1;0;5
Policia2;7;3
Policia3;15;3
Policia4;4;12
Policia5;10;18
Policia6;17;5
Policia7;15;19
Policia8;1;1
Ladron1;5;3;A
Ladron2;10;14;A
Ladron3;7;6;B
Ladron4;5;3;B
Ladron5;19;19;B
Ladron6;6;8;B
Ladron7;15;4;C