16
16
HHHAHHHHCHHHHHHH
SSSSSSSSSSSSSSSS
HHSHSHHHSHHHSHHH
SSSSSSSSSSSSSSSS
SHHHHHHSHHHHHHHS
SSSSSSSSSSSSSSSS
HSHHHHSAHSHHHHSH
SSSSSSSSSSSSSSSS
SHHHHHHHHHHHSHHH
SSSSSSSSSSSSSSSS
HHSHSHHHHHSHSHHH
SSSSSSSSSSSSSSSS
SHHHHHHSAHHHHHHS
SSSSSSSSSSSSSSSS
HSHHHHSHHSHHHHSH
SSSSSSSSSSSSSSSS
Policia1;0;5
Policia2;7;3
Ladron1;5;3
Ladron2;1;1
Ladron3;7;6